NO ./assets/north_texture.xpm
SO ./assets/wood_128x128.xpm
WE ./assets/west_texture.xpm
EA ./assets/east_texture.xpm

F 220,100,0
C 255,30,0,

1111111
1000001
1000001  1111111
1000001  1000001
1000001  1111111
1111111

1111111
1000001
100N101
1000001
1111111
